0000000000000000000000000000000000011110000
0000000000000000000000000000000000011110000
0000000000000000000000000000000000011110000
0000000000000000000000000000000000011110000
0000000000000000000000000000000000000000000
0000000000000000000000000000000000000000000
0000000000000000000000000000000000000000000
0000000000000000000111110000000000000000000
0000000000000000000111110000000000000000000
0000000000000000000111110000000000000111111
0000000000000000000111110000000000000000000
0000000000000000000111110000000000000000000
0000000000000000000111110000000000000000000
0000001111100000000111110000000000000000000
0000001111100000000111110000200000000001111
0000001111100000000111110000000000000001111