00000000000000000000000000000000
00000000000000000000000000000000
00000000000000000000000000000000
00001111110000000000000000000000
00000000000000000000000000000000
00000000000000000000000000000000
00000000000000000000000000000000
00000000000000000000000000000000
00000000000000000011111000000000
00000000000000000011111000000000
00000000000000000011111000000000
00000000000000000011111000000000
00000011111000000011111000000000
00000011111000000011111000000000
00000011111000000011111000002000
00000011111000000011111000002000